NO ./textures/north.xpm
EA ./textures/north.xpm
WE ./textures/north.xpm
SO ./textures/north.xpm
F 220,100,0
C 225,30,0

111111111111
100000010001
100000000001
100011100001
100000000001
101000000001
100000N00001
100001000001
100001000001
100001000001
100000000001
111111111111