NO ./textures/north.xpm
EA ./textures/north.xpm
SO ./textures/north.xpm
WE ./textures/north.xpm
F 220,100,0
C 225,30,0

                11111                                 111
                10001                                 101
111111111111111111P11111111111111111111111111111111111101
100000000000000000000000000000N00P00000000000000000000001
11111111111111111111111111P111111111111111111111111111111
		1000000000110000000000001
		1011000001110000000000001
		1001000000P00000000000001
111111111011000001110000000000001
1000000000110000011101111000111111
11110111111111011100000010001
11110111111111P11101010010001
11000000110101011100000010001
10000000000000001100000010001
10000000000000001101010010001
1100000111010101111101111000111
11110111 1110101 101111010001
11111111 1111111 111111111111