NO ./textures/north.xpm
SO ./textures/south.xpm
WE ./textures/west.xpm
EA ./textures/east.xpm
F 255,100,50
C 225,30,0

111111111111111111111111111111111111111111
100000000000000000000000000000000000000001
100000000000000000N00000000000000000000001
111111111111111111111111111111111111111111
