NO ./textures/north.xpm
SO ./textures/south.xpm
WE ./textures/west.xpm
EA ./textures/east.xpm

F 100,50,25
C 50,150,200

          1111
          1N01
          111
