NO ./textures/north.xpm
EA ./textures/north.xpm
SO ./textures/north.xpm
WE ./textures/north.xpm
F 220,100,0
C 225,30,0
	1111111
   111111111
  11111111111
 1111100011111
111110000011111
111100000001111
111100000001111
111100000001111
111100000001111
111110000011111
 1111100011111
  11111111111
   111111111
	1111111