NO ./textures/north.xpm
EA ./textures/north.xpm
WE ./textures/north.xpm
SO ./textures/north.xpm
F 220,100,0
C 225,30,0

                                                      111
                                                      101
111111111111111111111111111111111111111111111111111111101
100000000000000000000000000000W00000000000000000000000001
111111111111111111111111111111111111111111111111111111111