NO ./textures/north.xpm
SO ./textures/south.xpm
WE ./textures/west.xpm
EA ./textures/east.xpm
F 255,100,50
C 225,30,0

1111111
1000001
1N01001
1000001
1111111
