NO ./textures/north.xpm
SO ./textures/south.xpm
WE ./textures/west.xpm
EA ./textures/east.xpm
F 255,100,50
C 225,30,0

111111111
100000001
100N00001
100000001
111
