NO ./textures/north.xpm
SO ./textures/south.xpm
WE ./textures/west.xpm
EA ./textures/east.xpm
F 255,100,50
C 225,30,0

11111111111
10000000001
10000000001
10000N00001
10000000001
10000000001
11111110111
