NO ./textures/north.xpm
SO ./textures/south.xpm
WE ./textures/west.xpm
EA ./textures/east.xpm

F 220,100
C 225,30,0

1111111111111
1000000000001
1000000000001
1000N00000001
1000000000001
1000000000001
1111111111111
