NO ./assets/xpm/wall/test/wall4.xpm
EA ./assets/xpm/wall/test/wall4.xpm
WE ./assets/xpm/wall/test/wall4.xpm
SO ./assets/xpm/wall/test/wall4.xpm

C 20,20,20

F 42,42,42

1111
1111
1111
